20 20
19 1
3 0
####        ###    #
#### ######   # ####
##   ## #####   #  #
   #### ####### # ##
## ##   ####### # ##
##### #########   ##
####   ######## ####
#  ###     #    ####
##   ## ####### ####
####     #  ### ####
######## # ###   ###
####       ##### ###
#### ########### ###
#### # ####      ###
#      #  #### #####
#### # ##  ###     #
###### ### ### #####
# ###    # #      ##
#     ##     ## ####
# ############# ####